[Level 1]
0	6	6	0	1	6	6	0	7	0	1	6	7	1	1	0	1	0	1	0	0	1	0	1	7	1	0	1	0	1	0	1	0	1	0	1	1	1	0
0	3	1	2	1	2	1	3	7	3	0	3	0	3	1	2	0	3	0	2	1	3	0	3	0	2	0	2	1	2	0	3	1	3	0	2	1	3	5
1	1	0	1	0	0	1	1	0	0	1	1	0	1	0	0	4	1	0	1	1	0	0	1	1	1	0	1	0	1	0	1	0	1	1	0	0	1	5
0	3	0	3	1	2	0	2	1	3	0	3	0	3	0	2	0	2	0	3	0	3	0	2	0	2	0	2	5	3	0	3	0	3	0	2	0	3	0
0	0	0	0	0	1	1	1	1	0	0	0	1	1	0	0	0	1	1	1	1	0	0	0	1	1	1	1	0	0	1	1	1	1	0	0	1	1	1
1	3	1	2	1	3	0	3	0	2	1	3	1	3	1	2	0	2	1	3	1	3	1	3	0	2	0	2	0	3	5	2	1	2	1	3	1	2	0
1	1	1	1	0	0	1	1	7	1	1	0	1	1	0	0	1	1	1	0	1	1	1	0	1	0	1	0	5	1	0	1	0	1	0	1	1	1	7
0	3	0	2	5	2	0	2	7	3	1	2	1	3	0	2	0	3	0	2	0	2	1	2	0	3	1	2	1	2	0	3	1	2	0	3	1	3	0
0	1	1	1	0	1	0	1	0	1	0	1	0	0	0	1	1	1	7	0	4	0	1	1	1	1	1	0	0	0	4	1	1	1	1	0	0	1	1
1	2	0	3	1	3	0	3	0	3	6	3	1	2	0	2	0	2	0	3	5	2	0	2	0	3	0	2	0	3	5	3	0	2	1	3	1	2	1
6	0	0	0	1	0	1	0	4	0	5	0	1	1	1	0	0	1	1	0	0	1	1	1	1	1	0	0	0	0	0	1	1	1	0	1	1	0	0
1	3	1	2	1	3	0	3	0	2	0	3	1	2	0	2	7	3	0	2	0	3	0	2	1	2	1	3	1	3	7	2	0	2	0	3	0	3	1
1	6	0	0	1	1	0	0	7	0	0	1	1	0	0	1	6	0	1	0	0	1	0	6	1	1	1	6	0	1	6	0	1	1	0	1	0	1	1
0	3	1	2	0	2	0	2	7	3	1	3	1	2	1	3	1	2	1	3	1	2	1	2	1	3	1	3	1	2	0	2	0	3	1	3	1	2	0
5	0	0	1	5	4	0	1	0	1	0	0	7	0	1	1	1	1	1	0	1	4	0	1	1	1	0	4	1	0	1	1	5	1	0	1	1	0	1
1	3	0	2	1	2	1	3	1	2	1	3	0	2	0	2	1	3	1	2	0	3	1	2	1	2	1	3	0	2	1	3	0	2	7	3	1	3	0
1	1	1	0	1	1	1	0	1	0	0	1	1	0	1	1	1	0	1	1	1	0	1	1	1	1	0	1	1	0	4	1	1	1	1	0	1	1	5
0	3	1	2	1	2	1	3	1	3	1	2	1	3	1	2	0	3	0	2	0	2	1	3	1	3	1	2	0	3	0	2	1	3	0	2	0	3	0
[Level 2]
0	1	1	1	1	1	1	1	1	1	1	1	1	1	1	1	1	1	1	1	1	1	1	1	1	1	1	1	1	1	1	1	1	1	1	1	1	1	0
1	3	1	3	1	3	1	3	1	3	1	3	1	3	1	3	1	3	1	3	1	3	1	3	1	3	1	3	1	3	1	3	1	3	1	3	1	3	1
1	1	1	1	1	1	1	1	1	1	1	1	1	1	1	1	1	1	1	1	1	1	1	1	1	1	1	1	1	1	1	1	1	1	1	1	1	1	1
1	3	1	3	1	3	1	3	1	3	1	3	1	3	1	3	1	3	1	3	1	3	1	3	1	3	1	3	1	3	1	3	1	3	1	3	1	3	1
1	1	1	1	1	1	1	1	1	1	1	1	1	1	1	1	1	1	1	1	1	1	1	1	1	1	1	1	1	1	1	1	1	1	1	1	1	1	1
1	3	1	3	1	3	1	3	1	3	1	3	1	3	1	3	1	3	1	3	1	3	1	3	1	3	1	3	1	3	1	3	1	3	1	3	1	3	1
1	1	1	1	1	1	1	1	1	1	1	1	1	1	1	1	1	1	1	1	1	1	1	1	1	1	1	1	1	1	1	1	1	1	1	1	1	1	1
1	3	1	3	1	3	1	3	1	3	1	3	1	3	1	3	1	3	1	3	1	3	1	3	1	3	1	3	1	3	1	3	1	3	1	3	1	3	1
1	1	1	1	1	1	1	1	1	1	1	1	1	1	1	1	1	1	1	1	1	1	1	1	1	1	1	1	1	1	1	1	1	1	1	1	1	1	1
1	3	1	3	1	3	1	3	1	3	1	3	1	3	1	3	1	3	1	3	1	3	1	3	1	3	1	3	1	3	1	3	1	3	1	3	1	3	1
1	1	1	1	1	1	1	1	1	1	1	1	1	1	1	1	1	1	1	1	1	1	1	1	1	1	1	1	1	1	1	1	1	1	1	1	1	1	1
1	3	1	3	1	3	1	3	1	3	1	3	1	3	1	3	1	3	1	3	1	3	1	3	1	3	1	3	1	3	1	3	1	3	1	3	1	3	1
1	1	1	1	1	1	1	1	1	1	1	1	1	1	1	1	1	1	1	1	1	1	1	1	1	1	1	1	1	1	1	1	1	1	1	1	1	1	1
1	3	1	3	1	3	1	3	1	3	1	3	1	3	1	3	1	3	1	3	1	3	1	3	1	3	1	3	1	3	1	3	1	3	1	3	1	3	1
1	1	1	1	1	1	1	1	1	1	1	1	1	1	1	1	1	1	1	1	1	1	1	1	1	1	1	1	1	1	1	1	1	1	1	1	1	1	1
1	3	1	3	1	3	1	3	1	3	1	3	1	3	1	3	1	3	1	3	1	3	1	3	1	3	1	3	1	3	1	3	1	3	1	3	1	3	1
1	1	1	1	1	1	1	1	1	1	1	1	1	1	1	1	1	1	1	1	1	1	1	1	1	1	1	1	1	1	1	1	1	1	1	1	1	1	1
0	3	1	3	1	3	1	3	1	3	1	3	1	3	1	3	1	3	1	3	1	3	1	3	1	3	1	3	1	3	1	3	1	3	1	3	1	3	0